00000000111111
00000000111111
10000001111111
10000011111111
11000001011111
11000000001111
11000000001111
11000000001111
11100000001111
11100000001111
11100000001111
11100000011111
11110000011111
11100000011111
11110000011111
11100000011111
11110000011111
11100000011111
11110000011111
11100000011111
00000000001111
00000000011110
00000000000000
00000000000000
00000000000000
10000000000000
11100001100100
11100011111100
11110011111110
11110011111111
11110011111111
11110011111111
11111011111111
11110011111111
11110011111111
11110011111111
11110011111111
11110011111111
11110011111111
11100011111111
